NO assets/textures/BRICK_3B.xpm
SO assets/textures/BRICK_3D.xpm
WE assets/textures/CONCRETE_3C.xpm
EA ./assets/textures/wood.xpm
F 110,110,110
C 60,60,60





            1                                 11111   1  111                    
           101                  1            1000001 10110001111                
          100111 11            101           10000011100000000001               
          1000001001     1111111001          1000000000100011011                
          1011101001    10000000001          100000100010001001                 
          100010000111   1111111001           100001100000010001                
         10000000000001         101           10000100010101001                 
          1000000000001        1001         1110110000000000001                 
         10000000000001        10001    11110000100000000111101                 
          1100000001001       11001    100000000000000111    1                  
           10111000001       100001  1  101111101000001                         
           10000001101        1000111011101 1000000011                          
           10000000001        10000000000011000000001                           
           10000000001        100000000000000000000001                          
           10000000001        10000100010011101110101 1                         
           1000000000111      1001010000001  1  10111101                        
         1 10000001000001     1000001111101     10100001                        
        101 100000100111       10001    101    1100000011111                    
    111110111000001001   1     10001     1    100000000000001                   
   100000000000000100111101    10001          10000111000001                    
    100000100000000000000011   1001            110111101011                     
 11  100000011110110000000001  1001              11000000001                    
10011100000001 1011101101111   1001              1000110011                     
 100010000101  1000100101   1 100001              101 10001                     
1000000000101  1010011 1   10110001               101  101                      
 111111001101 11000001     1000001             1  1001 101                      
1000000000001100011101     1000001            1011101  101                      
 1110000000001000111011 1 10010001            1010101  101                      
   1010000000000000000010110000011111         1000101  101                      
   10111N10111111110001100000000000001       110000011  1                       
    1   1101       1000000000000000101      1100000101                         
         101       100000000000010010111111 10001011101                         
          1     11110000001000000000000000011110111 101                         
               10000001110111100000000001100000000011001                        
              10000001  101  100001000001100001110011001                        
   1          10000101   1   100000000000100101110011001                        
  101        1100100001      100001111111100001000001001                        
  101       1010010001       100001      10011101000101                         
 110111111111000100001       10111        11  1010000011                        
1000000000000011100101       101               1 10000001                       
1011110100001011101101        1                  1000111                        
10000000000010100000011                           111                           
 11110101100000001100001                                                        
 1000000000000000110111                                                         
 10010111100000000000001111111                                                  
 100101 11100010000000000000001                                                 
 100001100000000000001000000001                                                 
10000000000000000000000000000011                                                
100000000001000000001101100000001                                               
100000000001100000101100000011001                                               
1010011111000000000000000000110001                                              
101001 11100001001110111000011011                                               
10100110000000110011000000001001                                                
100000000000100000000001000011001                                               
 1110100000000110000000100100001                                                
 1000000010000000010000000001111                                                
 10001000111100000000000000000001                                               
 1000000000000000000000000000001                                                
  10000000101111111000011111001                                                 
   1111111 1       1111     11                                                  
