
NO ./assets/textures/bluestone.xpm
SO ./assets/textures/bluestone.xpm
WE ./assets/textures/bluestone.xpm
EA ./assets/textures/bluestone.xpm

F 110,110,110

C 60,60,60
 111111111
11S01
  11111 11111
