NO ./path_to_the_north_texture
SO ./path_to_the_south_texture
WE ./path_to_the_west_texture
EA ./path_to_the_east_texture
F 110,110,110
C 60,60,60

11111111111111111111111111
10000100000000000000010001
10000100000000000000000101
1E010000000000000000000001
10000000000000001000000001
10000000000000000000000001
10000000000000000000000001
11111111111111111111111111