NO ./path_to_the_north_texture
SO ./path_to_the_south_texture
WE ./path_to_the_west_texture
EA ./path_to_the_east_texture
F 110,110,110
C 60,60,60

        11111111111111111111111
        100000000110000001000001
        100000111000000100000111
        1001000000000000000000001
111111111111000001110000N00000001
100000000011000001110100111111111
10000000000000000000000000001
10000000000000000000000000001
10000001100000111100011000001
10000001100000000000110000011
10000000000000100000000000001
10000000000000000000000000001
10000000000000000000000000001
11110111110111011100000010001
11110111110111011101010010001
11000000110101011100000010001
10001000000000000000000000001
10000000000000000001010000001
11000001110101011111011110011
11110111111101011101111010001
11111111111111111111111111111
