NO assets/textures/TECH_2F.xpm
SO assets/textures/TECH_1E.xpm
EA assets/textures/TECH_3B.xpm
WE assets/textures/TECH_4F.xpm
C 0,0,0
F 36,36,35

11111111111111111111111111111111111111111111111111
10000000000001000000100000001000010000000010000001
10001100011101001100100011000101000101010010110101
10000001100001010010000100010010101010101001001001
10011110000001010000000101000100001000000100000001
10000001000001000101010101100001100000010111100001
10100100101110100101001000001110010110010000010001
10010110100000100101100011010001000001001100101001
11001000111000100100010000010101010101010010000011
10001011000100100011010100000010010110000001011001
10100000010110001000010011001010100001110100100101
10100100100001000101001000010010100100001010100001
10010000001001110001000010100100000011100000101011
10100001000100000000011100100011000100010011010001
10110001010011000011000001000100010010100000000101
10001010010100100100101010001000100000100101000001
11001010100000110001000100100110011100000100111111
10010010001110000100100110010001000010011010000001
10001000100001000010010001001001000010100001100101
10001111000101010001000101000100100100001010000101
100100000001000110100110010101010010111100000010N1
10010010010010000100100010010101010000001110001001
10011001001010110001001000010101000101100001001011
10000100100100001001010110100110100100010001101001
10110010010000100001000000010000101001001000010101
10001001001000010101110100111100100010001000000001
10100010010001100100001000010000001000100111101101
10100000100100010010110010100111110110010000010001
10011011001000001001000010010000000001010011001111
10100100100001100101001111001111010010011000100001
10100000100100010001010010010000101001000010000101
11000110100010001101010010100010100101100001110101
10001000101100100010010100000100010100010100001001
10100000010001010000010000001000010011000010100001
10010100100100001111111001101000001000100010011001
11010001000011100000010010001001100101010100100001
10011101010100010001000100010010010100001010100101
10100001011001010010101000100010000010010000111001
10110010000001010100000100001001001001010010000101
10001001000010010100010111110000000101000011110011
11100101000100100101010000000111001001000000001001
10001001001001010101011101110000001000111000101101
10001001001010000001000010000010100110000100010001
10110000101010111110110000011010100000100110010101
10000100110001000000001111100010011110010001100101
10101010001100010001100000010001000001101100000101
10100001100010000010000001010100011000000010000001
10010110000011111100011110010010100110011000111111
10010000000000000001000000100000000000000000000001
11111111111111111111111111111111111111111111111111
